4112112311211234
4       11     4
1     111      3
1     2        1
2     3        1
1    444     231
1     3        1
3     2        1
1            244
4411234        3
2     4        2
1     3   321144
3              3
1      3     211
2      4       4
4112112411211234